#############################################################
######~~~~~~~~~~~~~~~~~~~~########################~~~~#######
#~~##~~~################~~~~~~~~~~#~~~~~~~###~~~~~~##~~##~~~#
##~~~~####~~~~~~~~~~##########~####~#####~~#####~#####~~~~###
##~#####~~~#######~~~~~~~~~~~~~~~~~~~~##~~###~~~~##~~###~####
#~~##~~~~###~~~#################~###~~#~~###~~####~~~~##~~###
#~#~##~###~~~#~~~###~~~~~~###~~~~~##~##~###~~##~~~~##~~##~~##
#~#~#~~##~~#####~~~~~####~###~###~~###~~~~~~##########~~##~~#
#~~~#~##~~##~~##~#####~##~##~~~##~~###~#######~~~~~~###~###~#
##~##~###~~~~###~###~~~##~~~~#~##~###~~##~~~~~~####~~~~~###~#
#~~##~~#######~~~~~#~#~~###~####~~##~~##~~#########~#######~#
##~###~~###~~~~#####~##~######~~~###~###~##~~~###~~~~~###~~~#
##~~~##~~~~~#####~~~~##~~~~~~~~####~~~~#~~###~~######~~~~#~##
#~~#~~########~~~~#######~~##~######~#~##~####~~~~#####~##~##
###~~###~~~~~~~#####~~~~~~##~~~~~#####~##~~######~##~~#~~~~##
#~~~##~~~#######~~~~~###############~#~~##~~~#$##~##~###~####
#~#~##~###~~~#######~~~~~~~##~~~~###~##~~#~###~~#~##~#####~##
#~#~##~~##~#~~~~~#########~~~##~~~~~~#~~#~~##~~##~#~~~~#~~~~#
#~~~###~###~+##~~~~~~~~~~####~~~#~##~##~#~##~~~##~####~~~#~##
##~####~~~~~############~~~~~~#####~~##~#~~~~###~~~~~~~###~~#
##~~##########~~~~~~~~##########~~~~##~~######~~~#########~##
###~~##~#~#~~~~#####~~~~~~~~~~~~~##~###~~~~~~~~###~###~~~~~##
####~~~~~~~~~###~~~~~#############~~~#############~~~~~######
#############################################################
